date,amount,description,balance,word_embed
25/5/19,-9.3,COLES 7998 RICHMOND AU AUS Card xx2004 Value Date: 23/05/2019,986.49,-0.003782528
24/5/19,-12.5,Harlow                   Richmond     AU,995.79,-0.00197998
24/5/19,-11.5,BEEM IT                  BEEM.COM.AU  AU Card xx2004,1008.29,-0.003031447
23/5/19,-20.85,Direct Debit 010758 AHM 33695678,1019.79,-0.002965325
23/5/19,24,Refund Purchase BEEM IT                  BEEM.COM.AU  AU,1040.64,0.002153467
23/5/19,-9.85,COLES 7998 RICHMOND AU AUS Card xx2004 Value Date: 21/05/2019,1016.64,-0.003782528
22/5/19,-2,NHAN NGAI PTY. LTD.      CREMORNE     AU Card xx2004,1026.49,-0.001903355
22/5/19,-15.9,NHAN NGAI PTY. LTD.      CREMORNE     AU Card xx2004,1028.49,-0.001903355
22/5/19,-16,THE VAUCLUSE HOTEL RICHMOND VI AUS Card xx2004 Value Date: 17/05/2019,1044.39,-0.005288606
22/5/19,-25,Kayo Sports NORTH RYDE NS AUS Card xx2004 Value Date: 18/05/2019,1060.39,-0.002629263
22/5/19,-14,MHSOBFC SOUTH YARRA VI AUS Card xx2004 Value Date: 18/05/2019,1085.39,-0.005685434
21/5/19,-11.5,BEEM IT                  BEEM.COM.AU  AU Card xx2004,1099.39,-0.003031447
21/5/19,-0.57,International Transaction Fee Value Date: 16/05/2019,1110.89,0.006743108
21/5/19,-19.07,EIG*HOSTGATOR.COM 713-5745287 MA USA Card xx2004 USD 13.15 Value Date: 16/05/2019,1111.46,-0.004353466
21/5/19,-15,MHSOBFC SOUTH YARRA VI AUS Card xx2004 Value Date: 16/05/2019,1130.53,-0.005685434
20/5/19,-15,BERTIES BUTCHERS RICHM   RICHMOND     AU Card xx2004,1145.53,-0.009246348
19/5/19,45,Refund Purchase BEEM IT                  BEEM.COM.AU  AU,1160.53,0.002153467
19/5/19,45,Refund Purchase BEEM IT                  BEEM.COM.AU  AU,1115.53,0.002153467
19/5/19,-8.6,SPOTLESS FACILITY MCG    MELBOURNE    AU Card xx2004,1070.53,-0.004900113
19/5/19,-62,Harlow                   Richmond     AU,1079.13,-0.00197998
19/5/19,-135,Transfer to other Bank CommBank app footy tickets,1141.13,-0.004189742
18/5/19,-7.8,COLES 7998 RICHMOND AU AUS Card xx2004 Value Date: 16/05/2019,1276.13,-0.003782528
17/5/19,-10,Harlow                   Richmond     AU,1283.93,-0.00197998
17/5/19,-13,Abbotsford Cycles RICHMOND VI AUS Card xx2004 Value Date: 14/05/2019,1293.93,-0.007180858
17/5/19,-13,HARLEY HOWARD FREEHO RICHMOND VI AUS Card xx2004 Value Date: 14/05/2019,1306.93,-0.007056403
17/5/19,-31,HARLEY HOWARD FREEHO RICHMOND VI AUS Card xx2004 Value Date: 14/05/2019,1319.93,-0.007056403
16/5/19,-4500,Transfer to xx4944 CommBank app,1350.93,-0.012711523
16/5/19,-20.85,Direct Debit 010758 AHM 33695678,5850.93,-0.002965325
16/5/19,-52.2,Direct Debit 125206 FITNESS FIRST RI 015600018025010033,5871.78,-0.006010682
16/5/19,4300,Direct Credit 421520 ABAS PROPERTY SO 0140,5923.98,-0.008986221
16/5/19,-4.02,RICHMOND RECREATION RICHMOND VI AUS Card xx2004 Value Date: 14/05/2019,1623.98,-0.007839141
15/5/19,-11.5,BEEM IT                  BEEM.COM.AU  AU Card xx2004,1628,-0.003031447
15/5/19,-120,HEALTHY AFFAIR PTY L HAMPTON VI AUS Card xx2004 Value Date: 11/05/2019,1639.5,-0.003613875
15/5/19,-10,BRIGHTON CHOCOLATES BRIGHTON VI AUS Card xx2004 Value Date: 11/05/2019,1759.5,-0.006907276
15/5/19,-9.1,COLES 7998 RICHMOND AU AUS Card xx2004 Value Date: 13/05/2019,1769.5,-0.003782528
15/5/19,-45,SAY IT WITH FLOWERS MALVERN VI AUS Card xx2004 Value Date: 12/05/2019,1778.6,-0.007525686
15/5/19,-7,PAGE 8 HAMPTON HAMPTON VI AUS Card xx2004 Value Date: 11/05/2019,1823.6,-0.004140188
15/5/19,-47.5,ARCADIA HOTEL SOUTH YARRA VI AUS Card xx2004 Value Date: 10/05/2019,1830.6,-0.003882485
14/5/19,-111.04,"Direct Debit 119218 VODAFONE T1,2DF27D,29",1878.1,-0.006269228
14/5/19,-6000,Transfer to xx4944 CommBank app,1989.14,-0.012711523
14/5/19,-17.5,BERTIES BUTCHERS RICHM   RICHMOND     AU Card xx2004,7989.14,-0.009246348
14/5/19,4226.33,Salary realestate.com.a 00REA Salary,8006.64,-0.004520114
14/5/19,-32.51,A25 PIZZERIA SY South Yarra VI AUS Card xx2004 Value Date: 10/05/2019,3780.31,-0.007399063
14/5/19,-10,Royal Saxon Hotel Richmond VI AUS Card xx2004 Value Date: 10/05/2019,3812.82,-0.003619112
14/5/19,-10,Royal Saxon Hotel Richmond VI AUS Card xx2004 Value Date: 10/05/2019,3822.82,-0.003619112
14/5/19,-101.75,MHSOBFC SOUTH YARRA VI AUS Card xx2004 Value Date: 11/05/2019,3832.82,-0.005685434
14/5/19,-23,THAI AYOTHAYA MELB RICHMOND VI AUS Card xx2004 Value Date: 09/05/2019,3934.57,-0.009012562
11/5/19,5,Refund Purchase BEEM IT                  BEEM.COM.AU  AU,3957.57,0.002153467
11/5/19,3.5,Refund Purchase BEEM IT                  BEEM.COM.AU  AU,3952.57,0.002153467
11/5/19,60,Refund Purchase BEEM IT                  BEEM.COM.AU  AU,3949.07,0.002153467
11/5/19,-18.99,SOUL PRESS BRIGHTON PT   BRIGHTON     AU Card xx2004,3889.07,-0.001177864
10/5/19,-3,BEEM IT                  BEEM.COM.AU  AU Card xx2004,3908.06,-0.003031447
10/5/19,-11.8,Transfer to other Bank CommBank app pub lunch,3911.06,-0.009622368
10/5/19,-4.2,FitnessFirst_POS Richmond S AU AUS Card xx2004 Value Date: 08/05/2019,3922.86,-0.00235886
10/5/19,-10.4,COLES 7998 RICHMOND AU AUS Card xx2004 Value Date: 08/05/2019,3927.06,-0.003782528
9/5/19,-20.85,Direct Debit 010758 AHM 33695678,3937.46,-0.002965325
9/5/19,11.5,Transfer From KATYA FOSTER to PayID Phone medium Thai,3958.31,-0.009053244
9/5/19,-7.05,COLES 7998 RICHMOND AU AUS Card xx2004 Value Date: 07/05/2019,3946.81,-0.003782528
9/5/19,-89.2,BOOKTOPIA PTY LTD LIDCOMBE  AUS Card xx2004 Value Date: 08/05/2019,3953.86,-0.00722056
8/5/19,-360,Wdl ATM CBA ATM  WINDSOR        VIC 316297   AUS,4043.06,-0.006285476
8/5/19,-100,MYER  CHADSTONE CHADSTONE VI AUS Card xx2004 Value Date: 05/05/2019,4403.06,-0.006839923
8/5/19,-9.55,COLES 7998 RICHMOND AU AUS Card xx2004 Value Date: 06/05/2019,4503.06,-0.003782528
8/5/19,-4,MHSOBFC SOUTH YARRA VI AUS Card xx2004 Value Date: 04/05/2019,4512.61,-0.005685434
8/5/19,-12,MHSOBFC SOUTH YARRA VI AUS Card xx2004 Value Date: 04/05/2019,4516.61,-0.005685434
7/5/19,-4.2,FitnessFirst_POS Richmond S AU AUS Card xx2004 Value Date: 03/05/2019,4528.61,-0.00235886
7/5/19,-24,Royal Saxon Hotel Richmond VI AUS Card xx2004 Value Date: 03/05/2019,4532.81,-0.003619112
7/5/19,-15,MHSOBFC SOUTH YARRA VI AUS Card xx2004 Value Date: 02/05/2019,4556.81,-0.005685434
7/5/19,-41.45,COLES EXPRESS 6976 GLEN WAVERLEY AU AUS Card xx2004 Value Date: 04/05/2019,4571.81,-0.00460864
7/5/19,-14.26,THE CHERRY TREE HOTEL CREMORNE AU AUS Card xx2004 Value Date: 03/05/2019,4613.26,-0.007785001
5/5/19,-25,BEEM IT                  BEEM.COM.AU  AU Card xx2004,4627.52,-0.003031447
5/5/19,-23,BEEM IT                  BEEM.COM.AU  AU Card xx2004,4652.52,-0.003031447
4/5/19,75,Refund Purchase BEEM IT                  BEEM.COM.AU  AU,4675.52,0.002153467
4/5/19,-38,DR FOLLICLES BARBER      RICHMOND     AU Card xx2004,4600.52,-0.002212031
4/5/19,-9.55,COLES 7998 RICHMOND AU AUS Card xx2004 Value Date: 02/05/2019,4638.52,-0.003782528
3/5/19,-10,MYKI WINDSOR RS   WIN WINDSOR  AUS Card xx2004 Value Date: 29/04/2019,4648.07,-0.0071854
2/5/19,-20.85,Direct Debit 010758 AHM 33695678,4658.07,-0.002965325
2/5/19,-52.2,Direct Debit 125206 FITNESS FIRST RI 015600018025010032,4678.92,-0.006010682
2/5/19,-8.2,COLES 7998 RICHMOND AU AUS Card xx2004 Value Date: 30/04/2019,4731.12,-0.003782528
1/5/19,-172,BEEM IT                  BEEM.COM.AU  AU Card xx2004,4739.32,-0.003031447
1/5/19,11.5,Refund Purchase BEEM IT                  BEEM.COM.AU  AU,4911.32,0.002153467
1/5/19,-23,Transfer to other Bank CommBank app med thai,4899.82,-0.010087545
1/5/19,-10.7,COLES 7998 RICHMOND AU AUS Card xx2004 Value Date: 29/04/2019,4922.82,-0.003782528
1/5/19,-58.9,DUMPLING KING CREMORNE VI AUS Card xx2004 Value Date: 26/04/2019,4933.52,-0.005549602
1/5/19,-71.46,CRAZYDOMAINSHOSTING 61290372826 SG SGP Card xx2004 AUD 71.46 Value Date: 27/04/2019,4992.42,-0.003814215
30/4/19,-14.29,ADOBE  PHOTOGPHY PLAN 1800614863 IR IRL Card xx2004 AUD 14.29 Value Date: 26/04/2019,5063.88,-0.00332597
30/4/19,-44.3,Village Jam Factory SOUTH YARRA VI AUS Card xx2004 Value Date: 26/04/2019,5078.17,-0.008004789
30/4/19,-13.19,COLES 0677 VERMONT SOUTH AU AUS Card xx2004 Value Date: 27/04/2019,5122.47,-0.002203631
30/4/19,-8.6,UBER   *TRIP SYDNEY NS AUS Card xx2004 Value Date: 26/04/2019,5135.66,-0.000655154
27/4/19,-35,Transfer to other Bank CommBank app dinner,5144.26,-0.005044419
27/4/19,-6.5,COLES 7998 RICHMOND AU AUS Card xx2004 Value Date: 24/04/2019,5179.26,-0.003782528
27/4/19,-8.06,"Swan Hotel, Richmond Richmond VI AUS Card xx2004 Value Date: 24/04/2019",5185.76,-0.004893337
26/4/19,-20.85,Direct Debit 010758 AHM 33695678,5193.82,-0.002965325
26/4/19,50,Transfer From SAMANTHA TYRRELL CREDIT TO ACCOUNT,5214.67,-0.003536173
26/4/19,-22,Blackhearts&Sparrows     Richmond     AU,5164.67,-0.00197998
26/4/19,-16,Fonda                    Richmond     AU,5186.67,-0.00197998
25/4/19,-11,VILLAGE CENTURY CITY GLEN WAVERLEY VI AUS Card xx2004 Value Date: 19/04/2019,5202.67,-0.008539944
25/4/19,-28.59,7-ELEVEN 1286 GLEN WAVERLEY VI AUS Card xx2004 Value Date: 22/04/2019,5213.67,-0.006632262
25/4/19,-11.86,THE BUTCHERS CLUB AU GLEN WAVERLEY VI AUS Card xx2004 Value Date: 20/04/2019,5242.26,-0.005761132
25/4/19,-16,RITCHIES ROWVILLE VI AUS Card xx2004 Value Date: 20/04/2019,5254.12,-0.006839923
25/4/19,-6,RITCHIES ROWVILLE VI AUS Card xx2004 Value Date: 20/04/2019,5270.12,-0.006839923
25/4/19,-7,FitnessFirst_POS Richmond S AU AUS Card xx2004 Value Date: 22/04/2019,5276.12,-0.00235886
25/4/19,-11,COLES 7998 RICHMOND AU AUS Card xx2004 Value Date: 23/04/2019,5283.12,-0.003782528
24/4/19,-13,SPOTLESS FACILITY MCG    MELBOURNE    AU Card xx2004,5294.12,-0.004900113
24/4/19,-8.6,SPOTLESS FACILITY MCG    MELBOURNE    AU Card xx2004,5307.12,-0.004900113
24/4/19,-8.6,SPOTLESS FACILITY MCG    MELBOURNE    AU Card xx2004,5315.72,-0.004900113
24/4/19,-10,COLES 0575 MALVERN AU AUS Card xx2004 Value Date: 18/04/2019,5324.32,-0.002560467
24/4/19,-25,Kayo Sports NORTH RYDE NS AUS Card xx2004 Value Date: 18/04/2019,5334.32,-0.002629263
24/4/19,-95.04,BAHARI THE HELLENIC PA RICHMOND AU AUS Card xx2004 Value Date: 18/04/2019,5359.32,-0.006082356
24/4/19,-29.6,TARGET 5099 GLEN WAVERLEY AU AUS Card xx2004 Value Date: 20/04/2019,5454.36,-0.006349601
20/4/19,8,Refund Purchase BEEM IT                  BEEM.COM.AU  AU,5483.96,0.002153467
19/4/19,-35.2,SOUL PRESS BRIGHTON PT   BRIGHTON     AU Card xx2004,5475.96,-0.001177864
19/4/19,-8.9,COLES 7998 RICHMOND AU AUS Card xx2004 Value Date: 17/04/2019,5511.16,-0.003782528
19/4/19,-0.55,International Transaction Fee Value Date: 16/04/2019,5520.06,0.006743108
19/4/19,-18.42,EIG*HOSTGATOR.COM 713-5745287 MA USA Card xx2004 USD 13.15 Value Date: 16/04/2019,5520.61,-0.004353466
19/4/19,-4,SQ *HERESY PTY LTD Cremorne AU AUS Card xx2004 Value Date: 17/04/2019,5539.03,-0.004635583
19/4/19,-37,Abbotsford Cycles RICHMOND VI AUS Card xx2004 Value Date: 16/04/2019,5543.03,-0.007180858
18/4/19,-20.85,Direct Debit 010758 AHM 33695678,5580.03,-0.002965325
18/4/19,-52.2,Direct Debit 125206 FITNESS FIRST RI 015600018025010031,5600.88,-0.006010682
18/4/19,20.5,Refund Purchase BEEM IT                  BEEM.COM.AU  AU,5653.08,0.002153467
18/4/19,16,Refund Purchase BEEM IT                  BEEM.COM.AU  AU,5632.58,0.002153467
18/4/19,16,Refund Purchase BEEM IT                  BEEM.COM.AU  AU,5616.58,0.002153467
18/4/19,25,Refund Purchase BEEM IT                  BEEM.COM.AU  AU,5600.58,0.002153467
17/4/19,-12,MHSOBFC SOUTH YARRA VI AUS Card xx2004 Value Date: 13/04/2019,5575.58,-0.005685434
17/4/19,-9.15,COLES 7998 RICHMOND AU AUS Card xx2004 Value Date: 15/04/2019,5587.58,-0.003782528
17/4/19,-40,GENERAL PANTS 84 CHADSTONE VI AUS Card xx2004 Value Date: 13/04/2019,5596.73,-0.003686502
17/4/19,-15,THE VAUCLUSE HOTEL RICHMOND VI AUS Card xx2004 Value Date: 12/04/2019,5636.73,-0.005288606
16/4/19,-17,BERTIES BUTCHERS RICHM   RICHMOND     AU Card xx2004,5651.73,-0.009246348
16/4/19,-19.15,"Swan Hotel, Richmond Richmond VI AUS Card xx2004 Value Date: 12/04/2019",5668.73,-0.004893337
16/4/19,-8.06,"Swan Hotel, Richmond Richmond VI AUS Card xx2004 Value Date: 12/04/2019",5687.88,-0.004893337
16/4/19,-15,MHSOBFC SOUTH YARRA VI AUS Card xx2004 Value Date: 11/04/2019,5695.94,-0.005685434
16/4/19,-6.8,SQ *PIDAPIPO WINDSOR Windsor AU AUS Card xx2004 Value Date: 12/04/2019,5710.94,-0.003221428
15/4/19,-480,Wdl ATM CBA ATM  WINDSOR        VIC 316297   AUS,5717.74,-0.006285476
13/4/19,-7.8,BOOST JUICE PTY LTD      CHADSTONE    AU Card xx2004,6197.74,-0.006817154
13/4/19,-38,DR FOLLICLES BARBER      RICHMOND     AU Card xx2004,6205.54,-0.002212031
13/4/19,-101.75,MHSOBFC SOUTH YARRA VI AUS Card xx2004 Value Date: 11/04/2019,6243.54,-0.005685434
13/4/19,-6.65,COLES 7998 RICHMOND AU AUS Card xx2004 Value Date: 11/04/2019,6345.29,-0.003782528
12/4/19,-111.04,"Direct Debit 119218 VODAFONE T1,2DB7B6,10",6351.94,-0.006269228
12/4/19,4223.33,Salary realestate.com.a 00REA Salary,6462.98,-0.004520114
12/4/19,-9.15,COLES 7998 RICHMOND AU AUS Card xx2004 Value Date: 10/04/2019,2239.65,-0.003782528
11/4/19,-20.85,Direct Debit 010758 AHM 33695678,2248.8,-0.002965325
11/4/19,-73.5,MANGO TREE THAI MOUNT WAVERLE VI AUS Card xx2004 Value Date: 06/04/2019,2269.65,-0.015275324
11/4/19,-11.79,AMBULANCE VICTORIA MELBOURNE  AUS Card xx2004 Value Date: 06/04/2019,2343.15,-0.004609757
10/4/19,-9,COLES 7998 RICHMOND AU AUS Card xx2004 Value Date: 08/04/2019,2354.94,-0.003782528
9/4/19,-10.5,WEI TONG PTY. LTD.       RICHMOND     AU Card xx2004,2363.94,-0.00509521
9/4/19,-26.26,Loop Roof Melbourne VI AUS Card xx2004 Value Date: 05/04/2019,2374.44,-0.005737151
9/4/19,-15,MHSOBFC SOUTH YARRA VI AUS Card xx2004 Value Date: 04/04/2019,2400.7,-0.005685434
9/4/19,-36.83,COLES EXPRESS 6976 GLEN WAVERLEY AU AUS Card xx2004 Value Date: 06/04/2019,2415.7,-0.00460864
9/4/19,-11.5,COLES 0507 GLEN IRIS AU AUS Card xx2004 Value Date: 06/04/2019,2452.53,-0.003064215
9/4/19,-10,MYKI WINDSOR RS   WIN WINDSOR  AUS Card xx2004 Value Date: 04/04/2019,2464.03,-0.0071854
6/4/19,37,Refund Purchase BEEM IT                  BEEM.COM.AU  AU,2474.03,0.002153467
6/4/19,-8.43,UBER help.uber.com SYDNEY NS AUS Card xx2004 Value Date: 03/04/2019,2437.03,-0.000655154
6/4/19,143.18,Adjust Purchase DISPUTE ADJUSTMENT Card xx2004 AUD 143.18 Value Date: 08/03/2019,2445.46,-0.001385836
6/4/19,4.3,Rfnd O'Seas Transaction Value Date: 08/03/2019,2302.28,0.004724814
5/4/19,-5,IMAX THEATRE             CARLTON      AU Card xx2004,2297.98,-0.001736743
5/4/19,-29.5,BEEM IT                  BEEM.COM.AU  AU Card xx2004,2302.98,-0.003031447
5/4/19,13,Refund Purchase BEEM IT                  BEEM.COM.AU  AU,2332.48,0.002153467
5/4/19,30,Refund Purchase BEEM IT                  BEEM.COM.AU  AU,2319.48,0.002153467
5/4/19,0.97,Refund Purchase BEEM IT                  BEEM.COM.AU  AU,2289.48,0.002153467
5/4/19,-0.97,BEEM IT                  BEEM.COM.AU  AU Card xx2004,2288.51,-0.003031447
5/4/19,0.03,Refund Purchase BEEM IT                  BEEM.COM.AU  AU,2289.48,0.002153467
5/4/19,-0.03,BEEM IT                  BEEM.COM.AU  AU Card xx2004,2289.45,-0.003031447
5/4/19,-25,Prince Alfred Hotel      Richmond     AU,2289.48,0.001072559
5/4/19,-8.5,COLES 7998 RICHMOND AU AUS Card xx2004 Value Date: 03/04/2019,2314.48,-0.003782528
4/4/19,-20.05,Direct Debit 010758 AHM 33695678,2322.98,-0.002965325
4/4/19,-52.2,Direct Debit 125206 FITNESS FIRST RI 015600018025010030,2343.03,-0.006010682
4/4/19,-11.5,Transfer to other Bank CommBank app lunch money,2395.23,-0.007784404
4/4/19,-5.5,COLES 7998 RICHMOND AU AUS Card xx2004 Value Date: 02/04/2019,2406.73,-0.003782528
4/4/19,-10.3,COLES 7998 RICHMOND AU AUS Tap and Pay xx0513 Value Date: 01/04/2019,2412.23,-0.002179055
4/4/19,-15.7,DAN MURPHY'S 3625 MALVERN VI AUS Tap and Pay xx0513 Value Date: 29/03/2019,2422.53,-0.004367633
3/4/19,-28,TEMPLE HOTELS PTY LTD    MELBOURNE    AU Card xx2004,2438.23,-0.002978289
3/4/19,-7.6,7 GRAMS RICHMOND VI AUS Card xx2004 Value Date: 01/04/2019,2466.23,-0.008619416
3/4/19,-30.05,7-ELEVEN 1286 GLEN WAVERLEY VI AUS Card xx2004 Value Date: 30/03/2019,2473.83,-0.006632262
3/4/19,-63,HARDROCK CLIMBING PL MELBOURNE VI AUS Card xx2004 Value Date: 30/03/2019,2503.88,-0.004526234
3/4/19,-318,CR CHADSTONE CHADSTONE VI AUS Card xx2004 Value Date: 31/03/2019,2566.88,-0.01338083
2/4/19,-0.56,International Transaction Fee Value Date: 29/03/2019,2884.88,0.006743108
2/4/19,-18.59,EIG*HOSTGATOR.COM 713-5745287 MA USA Card xx2004 USD 13.15 Value Date: 29/03/2019,2885.44,-0.004353466
31/3/19,-153.92,MYER  CHADSTONE          CHADSTONE    AU,2904.03,0.005932872
30/3/19,-2.5,Non CBA ATM Withdrawal Fee,3057.95,-0.002551165
30/3/19,-100,Wdl ATM CAS 7-11 MELBOURNE (35BME       VI    AU,3060.45,-0.001786947
30/3/19,-64.15,AMAZON MKTPLC AU SYDNEY SOUTH NS AUS Card xx2004 Value Date: 26/03/2019,3160.45,-0.002876393
29/3/19,-14.29,ADOBE  PHOTOGPHY PLAN 1800614863 IR IRL Card xx2004 AUD 14.29 Value Date: 27/03/2019,3224.6,-0.00332597
29/3/19,-142.58,AMAZON AU SYDNEY SOUTH NS AUS Card xx2004 Value Date: 26/03/2019,3238.89,-0.002876393
28/3/19,-26,Transfer to CBA A/c CommBank app hot pot,3381.47,-0.011315423
28/3/19,-21.05,Direct Debit 010758 AHM 33695678,3407.47,-0.002965325
28/3/19,-6.55,COLES 7998 RICHMOND AU AUS Card xx2004 Value Date: 26/03/2019,3428.52,-0.003782528
28/3/19,-19.99,GAMES WORLD GLEN WAVERLEY VI AUS Tap and Pay xx0513 Value Date: 24/03/2019,3435.07,-0.00486416
27/3/19,-15,THE VAUCLUSE HOTEL RICHMOND VI AUS Card xx2004 Value Date: 22/03/2019,3455.06,-0.005288606
27/3/19,-56,JB HI FI THE GLEN GLEN WAVERLEY VI AUS Card xx2004 Value Date: 23/03/2019,3470.06,-0.004956929
27/3/19,-2,Le Crois Glen Waverley VI AUS Card xx2004 Value Date: 24/03/2019,3526.06,-0.004449792
26/3/19,-24.99,COLES EXPRESS 6976 GLEN WAVERLEY AU AUS Card xx2004 Value Date: 23/03/2019,3528.06,-0.00460864
26/3/19,-20,COLES 0508 GLEN WAVERLEY AU AUS Card xx2004 Value Date: 23/03/2019,3553.05,-0.003100658
23/3/19,-102,ADIDAS AUSTRALIA PTY L   MULGRAVE     AU Card xx2004,3573.05,-0.002219335
23/3/19,-420,Wdl ATM CBA ATM  RICHMOND STH B VIC 316602   AUS,3675.05,-0.006125407
23/3/19,-38,DR FOLLICLES BARBER      RICHMOND     AU Card xx2004,4095.05,-0.002212031
23/3/19,-19.9,HUNKY DORY FISH RICHMOND VI AUS Card xx2004 Value Date: 21/03/2019,4133.05,-0.004072054
23/3/19,-9.05,COLES 7998 RICHMOND AU AUS Card xx2004 Value Date: 21/03/2019,4152.95,-0.003782528
21/3/19,-21.05,Direct Debit 010758 AHM 33695678,4162,-0.002965325
21/3/19,-52.2,Direct Debit 125206 FITNESS FIRST RI 015600018025010029,4183.05,-0.006010682
21/3/19,-8.6,SPOTLESS FACILITY MCG    MELBOURNE    AU Card xx2004,4235.25,-0.004900113
21/3/19,-17.2,SPOTLESS FACILITY MCG    MELBOURNE    AU Card xx2004,4243.85,-0.004900113
21/3/19,-25,Kayo Sports NORTH RYDE NS AUS Card xx2004 Value Date: 19/03/2019,4261.05,-0.002629263
21/3/19,-8.8,COLES 7998 RICHMOND AU AUS Card xx2004 Value Date: 19/03/2019,4286.05,-0.003782528
21/3/19,-4,LITTLEBYLITTLECAFE BERWICK VI AUS Tap and Pay xx0513 Value Date: 17/03/2019,4294.85,-0.003983581
21/3/19,-39.92,7-ELEVEN 1286 GLEN WAVERLEY VI AUS Tap and Pay xx0513 Value Date: 16/03/2019,4298.85,-0.004286587
21/3/19,-8.85,THE YO MY COMPANY PT GLEN WAVERLEY VI AUS Tap and Pay xx0513 Value Date: 16/03/2019,4338.77,-0.006600951
20/3/19,-10.5,WEI TONG PTY. LTD.       RICHMOND     AU Card xx2004,4347.62,-0.00509521
20/3/19,-33.42,The Proud Peacock Res Mount Waverle VI AUS Tap and Pay xx0513 Value Date: 16/03/2019,4358.12,-0.003697151
18/3/19,800,Direct Credit 421520 SAMANTHA TYRRELL,4391.54,-0.003705993
18/3/19,266,Direct Credit 421520 SAMANTHA TYRRELL,3591.54,-0.003705993
18/3/19,-20,Wdl ATM CBA ATM  RICHMOND STH B VIC 316602   AUS,3325.54,-0.006125407
15/3/19,-111.04,"Direct Debit 119218 VODAFONE T1,2D77D8,37",3345.54,-0.006269228
14/3/19,-21.05,Direct Debit 010758 AHM 33695678,3456.58,-0.002965325
14/3/19,-4000,Transfer to xx4944 CommBank app,3477.63,-0.012711523
14/3/19,4246.33,Salary realestate.com.a 00REA Salary,7477.63,-0.004520114
14/3/19,-4.3,International Transaction Fee Value Date: 08/03/2019,3231.3,0.006743108
14/3/19,-143.18,KZA DISTRIBUTIO TOUZAC FR FRA Card xx2004 EUR 89.48 Value Date: 08/03/2019,3235.6,0.000705427
13/3/19,-6.5,Blackhearts&Sparrows Richmond VI AUS Card xx2004 Value Date: 08/03/2019,3378.78,-0.007450505
11/3/19,-100,Cardless Cash for collection,3385.28,-0.001237855
9/3/19,500,Cardless Cash return,3485.28,-0.002052882
9/3/19,-500,Cardless Cash for collection,2985.28,-0.001237855
8/3/19,-30,BEEM IT                  BEEM.COM.AU  AU Card xx5369,3485.28,-0.003031447
8/3/19,-24,Harlow                   Richmond     AU,3515.28,-0.00197998
8/3/19,-7.8,COLES 7998 RICHMOND AU AUS Card xx5369 Value Date: 06/03/2019,3539.28,-0.003782528
7/3/19,-21.05,Direct Debit 010758 AHM 33695678,3547.08,-0.002965325
7/3/19,-52.2,Direct Debit 125206 FITNESS FIRST RI 015600018025010028,3568.13,-0.006010682
7/3/19,-9.15,COLES 7998 RICHMOND AU AUS Card xx5369 Value Date: 05/03/2019,3620.33,-0.003782528
7/3/19,-17.99,Amazon Australia Servi MELBOURNE AU AUS Card xx5369 Value Date: 04/03/2019,3629.48,-0.004911687
7/3/19,-24,PONTOON STKILDA BEACH ST KILDA  AUS Card xx5369 Value Date: 02/03/2019,3647.47,-0.00594181
7/3/19,-5.2,MCDONALDS STH OAKLEIG OAKLEIGH SOUT  AUS Card xx5369 Value Date: 02/03/2019,3671.47,-0.007029359
6/3/19,-24.95,GENERAL PANTS 84 CHADSTONE VI AUS Card xx5369 Value Date: 03/03/2019,3676.67,-0.003686502
5/3/19,-12.5,Harlow Richmond VI AUS Card xx5369 Value Date: 01/03/2019,3701.62,-0.007450505
4/3/19,-15,BERTIES BUTCHERS RICHM   RICHMOND     AU Card xx5369,3714.12,-0.009246348
3/3/19,-31.5,SOUL PRESS BRIGHTON PT   BRIGHTON     AU Card xx5369,3729.12,-0.001177864
2/3/19,95,Refund Purchase BEEM IT                  BEEM.COM.AU  AU,3760.62,0.002153467
2/3/19,-183.5,RADIO MEXICO TAQUERI     ST KILDA     AU,3665.62,-0.005170586
2/3/19,45,Refund Purchase BEEM IT                  BEEM.COM.AU  AU,3849.12,0.002153467
2/3/19,-19,BEEM IT                  BEEM.COM.AU  AU Card xx5369,3804.12,-0.003031447
2/3/19,-38,DR FOLLICLES BARBER      RICHMOND     AU Card xx5369,3823.12,-0.002212031
2/3/19,-6.65,COLES 7998 RICHMOND AU AUS Card xx5369 Value Date: 28/02/2019,3861.12,-0.003782528
2/3/19,-84,MUSEUMS BOARD OF VIC CARLTON  AUS Card xx5369 Value Date: 28/02/2019,3867.77,-0.001756902
1/3/19,-25,Prince Alfred Hotel      Richmond     AU,3951.77,0.001072559
1/3/19,-8,SQ *HERESY PTY LTD Cremorne AU AUS Card xx5369 Value Date: 27/02/2019,3976.77,-0.004635583
1/3/19,-9.15,COLES 7998 RICHMOND AU AUS Card xx5369 Value Date: 27/02/2019,3984.77,-0.003782528
28/2/19,-21.05,Direct Debit 010758 AHM 33695678,3993.92,-0.002965325
28/2/19,-14.29,ADOBE  PHOTOGPHY PLAN 1800614863 IR IRL Card xx5369 AUD 14.29 Value Date: 26/02/2019,4014.97,-0.00332597
28/2/19,-7.8,COLES 7998 RICHMOND AU AUS Card xx5369 Value Date: 26/02/2019,4029.26,-0.003782528
27/2/19,-10.3,COLES 7998 RICHMOND AU AUS Card xx5369 Value Date: 25/02/2019,4037.06,-0.003782528
27/2/19,-25.2,THE BUTLERS PANTRY A ROWVILLE VI AUS Card xx5369 Value Date: 24/02/2019,4047.36,-0.007035551
26/2/19,-84,SOCIAL SPORT PTY LTD     RICHMOND     AU Card xx5369,4072.56,-0.005229992
26/2/19,-32.8,Waterfalls Cafe Mount Field TA AUS Card xx5369 Value Date: 22/02/2019,4156.56,-0.008220151
26/2/19,-15,GRAHAM O'KEEFE ADVENTURE BAY TA AUS Card xx5369 Value Date: 20/02/2019,4189.36,-0.0068161
23/2/19,-35.69,BP HOBART AIRPORT 1 CAMBRIDGE         AU,4204.36,-0.001137858
23/2/19,65,Refund Purchase BEEM IT                  BEEM.COM.AU  AU,4240.05,0.002153467
23/2/19,-137.6,BALL AND CHAIN GRILL     HOBART       AU,4175.05,0.002962724
23/2/19,-100,Wdl ATM ANZ SALAMANCA 6 MONTPELSALAMANCA      AU,4312.65,-0.000764452
23/2/19,-477.3,THE OLD WOOLSTORE APAR   HOBART       AU,4412.65,0.002869407
23/2/19,-31,Mona - Cafe Berriedale TA AUS Card xx5369 Value Date: 21/02/2019,4889.95,-0.006386489
23/2/19,-53.3,COLES EXPRESS 1523 SORELL AU AUS Card xx5369 Value Date: 21/02/2019,4920.95,-0.00440981
23/2/19,-19.3,COLES 7500 SORELL AU AUS Card xx5369 Value Date: 21/02/2019,4974.25,-0.002560467
23/2/19,-17.75,MCDONALDS SORELL SORELL  AUS Card xx5369 Value Date: 19/02/2019,4993.55,-0.008341283
22/2/19,-95,BEEM IT                  BEEM.COM.AU  AU Card xx5369,5011.3,-0.003031447
22/2/19,50,Refund Purchase BEEM IT                  BEEM.COM.AU  AU,5106.3,0.002153467
22/2/19,-45,BRUNY ISLAND CHEESE GREAT BAY TA AUS Card xx5369 Value Date: 20/02/2019,5056.3,-0.005999378
21/2/19,-21.05,Direct Debit 010758 AHM 33695678,5101.3,-0.002965325
21/2/19,-52.2,Direct Debit 125206 FITNESS FIRST RI 015600018025010027,5122.35,-0.006010682
21/2/19,-15.5,WOOLWORTHS W7012         HOBART       AU Card xx5369,5174.55,-0.003110846
21/2/19,-57,FISH FRENZY              HOBART       AU Card xx5369,5190.05,-0.001518446
21/2/19,9.5,Refund Purchase BEEM IT                  BEEM.COM.AU  AU,5247.05,0.002153467
21/2/19,25,Refund Purchase BEEM IT                  BEEM.COM.AU  AU,5237.55,0.002153467
21/2/19,-7,MATHEW JAMES STAPENE FORTESCUE TA AUS Card xx5369 Value Date: 19/02/2019,5212.55,-0.004988455
20/2/19,-5,BEEM IT                  BEEM.COM.AU  AU Card xx5369,5219.55,-0.003031447
20/2/19,-34,BEEM IT                  BEEM.COM.AU  AU Card xx5369,5224.55,-0.003031447
20/2/19,-9.1,BANJOS MARGATE           MARGATE      AU Card xx5369,5258.55,-0.00513673
20/2/19,-0.56,International Transaction Fee Value Date: 16/02/2019,5267.65,0.006743108
20/2/19,-18.57,EIG*HOSTGATOR.COM 713-5745287 MA USA Card xx5369 USD 13.15 Value Date: 16/02/2019,5268.21,-0.004353466
19/2/19,-45.64,COLES 7500 SORELL AU AUS Card xx5369 Value Date: 15/02/2019,5286.78,-0.002560467
19/2/19,-45.55,COLES EXPRESS 1523 SORELL AU AUS Card xx5369 Value Date: 15/02/2019,5332.42,-0.00440981
16/2/19,-38,Ge'ographe Coles Bay Coles Bay TA AUS Card xx5369 Value Date: 14/02/2019,5377.97,-0.005456293
16/2/19,-76.11,ST HELENS SUPA IGA ST HELENS  AUS Card xx5369 Value Date: 13/02/2019,5415.97,-0.006337208
15/2/19,-42.1,JULFRAN PTY LIMITED      SORELL       AU Card xx5369,5492.08,-0.002134235
15/2/19,-127.87,COLES 7500               SORELL       AU,5534.18,0.004564309
15/2/19,-18,BEEM IT                  BEEM.COM.AU  AU Card xx5369,5662.05,-0.003031447
15/2/19,-56,FREYCINET MARINE FAR COLES BAY TA AUS Card xx5369 Value Date: 13/02/2019,5680.05,-0.007189805
15/2/19,-16,SQ *BAY OF FIRES BUSH St Helens AU AUS Card xx5369 Value Date: 13/02/2019,5736.05,-0.004962671
15/2/19,-269.1,MACPAC LAUNCESTON LAUNCESTON  AUS Card xx5369 Value Date: 11/02/2019,5752.05,-0.007310317
15/2/19,-63.73,BONDS LAUNCESTON LAUNCESTON  AUS Card xx5369 Value Date: 11/02/2019,6021.15,-0.007005088
14/2/19,-21.05,Direct Debit 010758 AHM 33695678,6084.88,-0.002965325
14/2/19,4226.44,Salary realestate.com.a 00REA Salary,6105.93,-0.004520114
14/2/19,-19.99,DPIPWE PWS CRADLE MOUNTA  AUS Card xx5369 Value Date: 10/02/2019,1879.49,-0.011667164
14/2/19,-57.5,TAS FOOD & WINE CONS SASSAFRAS TA AUS Card xx5369 Value Date: 09/02/2019,1899.48,-0.005741657
13/2/19,40,Refund Purchase BEEM IT                  BEEM.COM.AU  AU,1956.98,0.002153467
13/2/19,-1656.5,APEX CAR RENTALS LAUNCESTON TA AUS Card xx5369 Value Date: 09/02/2019,1916.98,-0.004274008
12/2/19,-111.04,"Direct Debit 119218 VODAFONE T1,2D2B2D,47",3573.48,-0.006269228
12/2/19,-41.91,HILLYS VALUE PLUS I      ST HELENS    AU Card xx5369,3684.52,-0.004368376
12/2/19,-12.99,Amazon Australia Servi MELBOURNE AU AUS Card xx5369 Value Date: 08/02/2019,3726.43,-0.004911687
12/2/19,-15.47,Amazon Australia Servi MELBOURNE AU AUS Card xx5369 Value Date: 08/02/2019,3739.42,-0.004911687
12/2/19,-4.7,Muffin Break T4 Tullamarine VI AUS Card xx5369 Value Date: 09/02/2019,3754.89,-0.005828384
11/2/19,-300,BLACK COW BISTRO    LAUNCESTON        AU,3759.59,-0.002000288
11/2/19,-18.5,Saint John Craft Beer    Launceston   AU,4059.59,0.001034232
11/2/19,-20,BEEM IT                  BEEM.COM.AU  AU Card xx5369,4078.09,-0.003031447
9/2/19,30,Refund Purchase BEEM IT                  BEEM.COM.AU  AU,4098.09,0.002153467
9/2/19,-68.2,WOOLWORTHS 7220          LAUNCESTON   AU Card xx5369,4068.09,-0.003110846
9/2/19,-9.9,BRUNETTI AIRPORTS PT     MELBOURNE AIRAU Card xx5369,4136.29,-0.006494746
8/2/19,-30.29,BP E/PRAHRAN 0082   PRAHRAN           AU,4146.19,0.005876293
8/2/19,-10.5,WEI TONG PTY. LTD.       RICHMOND     AU Card xx5369,4176.48,-0.00509521
8/2/19,-19,K Z ENTERPRSS AUST P RICHMOND VI AUS Card xx5369 Value Date: 04/02/2019,4186.98,-0.007899727
8/2/19,-10,MYKI WINDSOR RS   WIN WINDSOR  AUS Card xx5369 Value Date: 04/02/2019,4205.98,-0.0071854
7/2/19,-21.05,Direct Debit 010758 AHM 33695678,4215.98,-0.002965325
7/2/19,-52.2,Direct Debit 125206 FITNESS FIRST RI 015600018025010026,4237.03,-0.006010682
7/2/19,-47,Transfer To J WARNE PayID Phone from CommBank app bin cleaning services + resume review...,4289.23,-0.005658342
6/2/19,-13.5,COLES 7868 COWES AU AUS Card xx5369 Value Date: 04/02/2019,4336.23,-0.002560467
6/2/19,-4.86,COLES 0573 PRAHRAN AU AUS Card xx5369 Value Date: 03/02/2019,4349.73,-0.002560467
5/2/19,-9.4,COLES 7998 RICHMOND AU AUS Card xx5369 Value Date: 02/02/2019,4354.59,-0.003782528
3/2/19,-14,SOUL PRESS BRIGHTON PT   BRIGHTON     AU Card xx5369,4363.99,-0.001177864
2/2/19,-38,DR FOLLICLES BARBER      RICHMOND     AU Card xx5369,4377.99,-0.002212031
2/2/19,-15,THE BEER & BURGER CA RICHMOND VI AUS Card xx5369 Value Date: 30/01/2019,4415.99,-0.007948959
2/2/19,-74.75,CRAZYDOMAINSHOSTING 61290372826 SG SGP Card xx5369 AUD 74.75 Value Date: 30/01/2019,4430.99,-0.003814215
31/1/19,-21.05,Direct Debit 010758 AHM 33695678,4505.74,-0.002965325
31/1/19,-7.05,COLES 7998 RICHMOND AU AUS Card xx5369 Value Date: 29/01/2019,4526.79,-0.003782528
31/1/19,-17,I Carussi II St Kilda VI AUS Card xx5369 Value Date: 28/01/2019,4533.84,-0.006968717
31/1/19,5,Return GFM*GOFUNDME AUSTRALIA Sydney AU AUS Card xx5369 Value Date: 28/01/2019,4550.84,-0.002586941
30/1/19,-8,SAINT THOMAS COFFE RICHMOND VI AUS Card xx5369 Value Date: 25/01/2019,4545.84,-0.004490636
30/1/19,-11.04,COLES 7998 RICHMOND AU AUS Card xx5369 Value Date: 25/01/2019,4553.84,-0.003782528
30/1/19,-14.29,ADOBE  PHOTOGPHY PLAN 1800614863 IR IRL Card xx5369 AUD 14.29 Value Date: 26/01/2019,4564.88,-0.00332597
30/1/19,-50,LIQUORLAND 2955 LARA AU AUS Card xx5369 Value Date: 26/01/2019,4579.17,-0.00357245
30/1/19,-44.12,COLES 0573 PRAHRAN AU AUS Card xx5369 Value Date: 26/01/2019,4629.17,-0.002560467
30/1/19,-62.5,SP * EUBI AUSTRALIA BAYSWATER VI AUS Card xx5369 Value Date: 27/01/2019,4673.29,-0.005945382
30/1/19,-20,MR BLACK JUICERY BERWICK VI AUS Card xx5369 Value Date: 27/01/2019,4735.79,-0.005976794
26/1/19,-7.1,Transfer To William Siebuhr PayID Phone from CommBank app pingers,4755.79,-0.011750582
26/1/19,-240,Wdl ATM CBA ATM  WINDSOR        VIC 316297   AUS,4762.89,-0.006285476
26/1/19,-9.55,COLES 7998 RICHMOND AU AUS Card xx5369 Value Date: 24/01/2019,5002.89,-0.003782528
25/1/19,-9.15,COLES 7998 RICHMOND AU AUS Card xx5369 Value Date: 23/01/2019,5012.44,-0.003782528
24/1/19,-21.05,Direct Debit 010758 AHM 33695678,5021.59,-0.002965325
24/1/19,-52.2,Direct Debit 125206 FITNESS FIRST RI 015600018025010025,5042.64,-0.006010682
24/1/19,-33.53,BP MALVERN 0559     MALVERN           AU,5094.84,0.005876293
24/1/19,-7.8,COLES 7998 RICHMOND AU AUS Card xx5369 Value Date: 22/01/2019,5128.37,-0.003782528
23/1/19,-10.3,COLES 7998 RICHMOND AU AUS Card xx5369 Value Date: 21/01/2019,5136.17,-0.003782528
23/1/19,-5,PENINSULA HOT SPRG FINGAL VI AUS Card xx5369 Value Date: 19/01/2019,5146.47,-0.004583371
22/1/19,-20.5,Transfer To Benjamin Theunissen PayID Phone from CommBank app pingers,5151.47,-0.010772946
22/1/19,-130,PENINSULA HOT SPRI FINGAL VI AUS Card xx5369 Value Date: 17/01/2019,5171.97,-0.004583371
22/1/19,-13,Mubble Rye Rye VI AUS Card xx5369 Value Date: 19/01/2019,5301.97,-0.006035542
19/1/19,-21,T'Gallant Restaurant     Main Ridge   AU,5314.97,-0.004328823
19/1/19,-50,T'Gallant Restaurant     Main Ridge   AU,5335.97,-0.004328823
19/1/19,-7.8,COLES 7998 RICHMOND AU AUS Card xx5369 Value Date: 17/01/2019,5385.97,-0.003782528
19/1/19,-0.55,International Transaction Fee Value Date: 16/01/2019,5393.77,0.006743108
19/1/19,-18.36,EIG*HOSTGATOR.COM 713-5745287 MA USA Card xx5369 USD 13.15 Value Date: 16/01/2019,5394.32,-0.004353466
18/1/19,-17.5,BERTIES BUTCHERS RICHM   RICHMOND     AU Card xx5369,5412.68,-0.009246348
18/1/19,-12,DENIS THE MENANCE CREMORNE VI AUS Card xx5369 Value Date: 15/01/2019,5430.18,-0.005070437
17/1/19,-21.05,Direct Debit 010758 AHM 33695678,5442.18,-0.002965325
17/1/19,-7.8,COLES 7998 RICHMOND AU AUS Card xx5369 Value Date: 15/01/2019,5463.23,-0.003782528
17/1/19,-4,K Z ENTERPRSS AUST P RICHMOND VI AUS Card xx5369 Value Date: 11/01/2019,5471.03,-0.007899727
16/1/19,-20,Wdl ATM CBA ATM  RICHMOND STH B VIC 316602   AUS,5475.03,-0.006125407
16/1/19,-10.3,COLES 7998 RICHMOND AU AUS Card xx5369 Value Date: 14/01/2019,5495.03,-0.003782528
16/1/19,-24.95,GENERAL PANTS CO FOUNTAIN GATE VI AUS Card xx5369 Value Date: 13/01/2019,5505.33,-0.005370513
15/1/19,-111.04,"Direct Debit 119218 VODAFONE T1,2CE71E,46",5530.28,-0.006269228
15/1/19,-10,Harlow Richmond VI AUS Card xx5369 Value Date: 11/01/2019,5641.32,-0.007450505
15/1/19,-12.5,Harlow Richmond VI AUS Card xx5369 Value Date: 11/01/2019,5651.32,-0.007450505
15/1/19,-4,K Z ENTERPRSS AUST P RICHMOND VI AUS Card xx5369 Value Date: 09/01/2019,5663.82,-0.007899727
15/1/19,-1.5,COLES 0677 VERMONT SOUTH AU AUS Card xx5369 Value Date: 12/01/2019,5667.82,-0.002203631
15/1/19,-0.14,COLES 0677 VERMONT SOUTH AU AUS Card xx5369 Value Date: 12/01/2019,5669.32,-0.002203631
15/1/19,-23.05,COLES 0677 VERMONT SOUTH AU AUS Card xx5369 Value Date: 12/01/2019,5669.46,-0.002203631
15/1/19,-21.9,Eating House Rowville Rowville VI AUS Card xx5369 Value Date: 12/01/2019,5692.51,-0.007025396
14/1/19,-30,BEEM IT                  BEEM.COM.AU  AU Card xx5369,5714.41,-0.003031447
13/1/19,-250,Wdl ATM CBA ATM  EDEN RISE VL A VIC 335901   AUS,5744.41,-0.007495886
13/1/19,-18.99,SOUL PRESS BRIGHTON PT   BRIGHTON     AU Card xx5369,5994.41,-0.001177864
12/1/19,-290,BEEM IT                  BEEM.COM.AU  AU Card xx5369,6013.4,-0.003031447
12/1/19,-10.3,COLES 7998 RICHMOND AU AUS Card xx5369 Value Date: 10/01/2019,6303.4,-0.003782528
11/1/19,4256.45,Salary realestate.com.a 00REA Salary,6313.7,-0.004520114
11/1/19,-13,NHAN NGAI PTY. LTD.      CREMORNE     AU Card xx5369,2057.25,-0.001903355
11/1/19,-7.8,COLES 7998 RICHMOND AU AUS Card xx5369 Value Date: 09/01/2019,2070.25,-0.003782528
10/1/19,-21.05,Direct Debit 010758 AHM 33695678,2078.05,-0.002965325
10/1/19,-52.2,Direct Debit 125206 FITNESS FIRST RI 015600018025010024,2099.1,-0.006010682
10/1/19,-6.65,COLES 7998 RICHMOND AU AUS Card xx5369 Value Date: 08/01/2019,2151.3,-0.003782528
9/1/19,-4,SQ *HERESY PTY LTD Cremorne VI AUS Card xx5369 Value Date: 07/01/2019,2157.95,-0.00625867
9/1/19,-9.15,COLES 7998 RICHMOND AU AUS Card xx5369 Value Date: 07/01/2019,2161.95,-0.003782528
8/1/19,-3.6,RSS ENTERPRISES PTY LT   BULLEEN      AU Card xx5369,2171.1,-0.005826723
8/1/19,-5.5,COLES 7998 RICHMOND AU AUS Card xx5369 Value Date: 04/01/2019,2174.7,-0.003782528
8/1/19,-23.5,The Little Ox Brighton VI AUS Card xx5369 Value Date: 05/01/2019,2180.2,-0.003710277
8/1/19,-11.85,MCDONALDS LEONGATHA LEONGATHA  AUS Card xx5369 Value Date: 03/01/2019,2203.7,-0.008341283
6/1/19,-38,T'Gallant Restaurant     Main Ridge   AU,2215.55,-0.004328823
5/1/19,-14,SOUL PRESS BRIGHTON PT   BRIGHTON     AU Card xx5369,2253.55,-0.001177864
5/1/19,-65,DR FOLLICLES BARBER      RICHMOND     AU Card xx5369,2267.55,-0.002212031
5/1/19,-50.19,7-ELEVEN 1286 GLEN WAVERLEY VI AUS Card xx5369 Value Date: 03/01/2019,2332.55,-0.006632262
5/1/19,-4.55,MCDONALDS CALDERMEADE CALDERMEADE  AUS Card xx5369 Value Date: 01/01/2019,2382.74,-0.008341283
3/1/19,-21.05,Direct Debit 010758 AHM 33695678,2387.29,-0.002965325
3/1/19,-12.2,BEEM IT                  BEEM.COM.AU  AU Card xx5369,2408.34,-0.003031447
3/1/19,-7,COLES 0677 VERMONT SOUTH AU AUS Card xx5369 Value Date: 31/12/2018,2420.54,-0.002203631
3/1/19,-59.95,PATAGONIA AUSTRALIA BURLEIGH HEAD QL AUS Card xx5369 Value Date: 30/12/2018,2427.54,-0.00507002
3/1/19,-6.8,COLES 4583 MIAMI AU AUS Card xx5369 Value Date: 30/12/2018,2487.49,-0.002847181
3/1/19,-31,COMMUNE ESPRESSO PL BURLEIGH HEAD QL AUS Card xx5369 Value Date: 30/12/2018,2494.29,-0.004822446
1/1/19,-13,BEEM IT                  BEEM.COM.AU  AU Card xx5369,2525.29,-0.003031447
1/1/19,-49.97,MYER  PACIFIC FAIR BROADBEACH QL AUS Card xx5369 Value Date: 28/12/2018,2538.29,-0.005073199
1/1/19,-21.23,COLES 4583 MIAMI AU AUS Card xx5369 Value Date: 28/12/2018,2588.26,-0.002847181
1/1/19,-98.2,Elk Espresso Broadbeach QL AUS Card xx5369 Value Date: 28/12/2018,2609.49,-0.004565291
1/1/19,-46.85,COLES 4583 MIAMI AU AUS Card xx5369 Value Date: 29/12/2018,2707.69,-0.002847181
31/12/18,-20,BEEM IT                  BEEM.COM.AU  AU Card xx5369,2754.54,-0.003031447
31/12/18,-52.89,DAN MURPHYS LIQ W3220    NUNAWADING   AU Card xx5369,2774.54,-0.003699621
31/12/18,-14.48,CHEMIST WAREHOUSE   MOUNT WAVERLE     AU,2827.43,-0.00700021
30/12/18,-10.5,NORTH BURLEIGH SURF      MIAMI        AU Card xx5369,2841.91,-0.000354169
30/12/18,-7.6,NORTH BURLEIGH SURF      MIAMI        AU Card xx5369,2852.41,-0.000354169
30/12/18,-55.5,NORTH BURLEIGH SLSC      MIAMI        AU Card xx5369,2860.01,-0.001819311
30/12/18,-12.1,NORTH BURLEIGH SURF      MIAMI        AU Card xx5369,2915.51,-0.000354169
30/12/18,-5,BEEM IT                  BEEM.COM.AU  AU Card xx5369,2927.61,-0.003031447
30/12/18,-7.5,BEEM IT                  BEEM.COM.AU  AU Card xx5369,2932.61,-0.003031447
29/12/18,10,Refund Purchase BEEM IT                  BEEM.COM.AU  AU,2940.11,0.002153467
29/12/18,-4.9,COLES 4520 BURLEIGH HDS AU AUS Card xx5369 Value Date: 27/12/2018,2930.11,-0.002560467
28/12/18,-34,BEEM IT                  BEEM.COM.AU  AU Card xx5369,2935.01,-0.003031447
28/12/18,10,Refund Purchase BEEM IT                  BEEM.COM.AU  AU,2969.01,0.002153467
28/12/18,-129.6,TH PACIFIC FAIR          BROADBEACH   AU,2959.01,-0.000113757
28/12/18,23,Refund Purchase BEEM IT                  BEEM.COM.AU  AU,3088.61,0.002153467
28/12/18,47,Refund Purchase BEEM IT                  BEEM.COM.AU  AU,3065.61,0.002153467
28/12/18,-7.5,BEEM IT                  BEEM.COM.AU  AU Card xx5369,3018.61,-0.003031447
28/12/18,-15,THE VAUCLUSE HOTEL RICHMOND VI AUS Card xx5369 Value Date: 21/12/2018,3026.11,-0.005288606
28/12/18,-89.95,MYER  CHADSTONE CHADSTONE VI AUS Card xx5369 Value Date: 22/12/2018,3041.11,-0.006839923
28/12/18,-553,VillageRdshwThemeParks SOUTH YARRA VI AUS Card xx5369 Value Date: 24/12/2018,3131.06,-0.005685434
28/12/18,-18,BOOST JUICE BAR MELBOURNE AIR VI AUS Card xx5369 Value Date: 22/12/2018,3684.06,-0.007173868
28/12/18,-146.73,UBER   *TRIP VDK2C SYDNEY NS AUS Card xx5369 Value Date: 22/12/2018,3702.06,-0.000655154
28/12/18,-38.09,COLES 4583 MIAMI AU AUS Card xx5369 Value Date: 24/12/2018,3848.79,-0.002847181
28/12/18,-15.72,COLES 4583 MIAMI AU AUS Card xx5369 Value Date: 23/12/2018,3886.88,-0.002847181
28/12/18,-14.29,ADOBE  PHOTOGPHY PLAN 1800614863 IR IRL Card xx5369 AUD 14.29 Value Date: 26/12/2018,3902.6,-0.00332597
28/12/18,-65,COLES 4583 MIAMI AU AUS Card xx5369 Value Date: 26/12/2018,3916.89,-0.002847181
27/12/18,-21.05,Direct Debit 010758 AHM 33695678,3981.89,-0.002965325
27/12/18,-52.2,Direct Debit 125206 FITNESS FIRST RI 015600018025010023,4002.94,-0.006010682
27/12/18,-39.8,EURO GRILL               BURLEIGH WATEAU Card xx5369,4055.14,-0.006045664
27/12/18,7,Refund Purchase BEEM IT                  BEEM.COM.AU  AU,4094.94,0.002153467
27/12/18,-14,EURO GRILL               BURLEIGH WATEAU Card xx5369,4087.94,-0.006045664
26/12/18,-7.6,NORTH BURLEIGH SURF      MIAMI        AU Card xx5369,4101.94,-0.000354169
26/12/18,40,Refund Purchase BEEM IT                  BEEM.COM.AU  AU,4109.54,0.002153467
26/12/18,-51.15,NORTH BURLEIGH SLSC      MIAMI        AU Card xx5369,4069.54,-0.001819311
26/12/18,-5,BEEM IT                  BEEM.COM.AU  AU Card xx5369,4120.69,-0.003031447
26/12/18,-15.5,NORTH BURLEIGH SURF      MIAMI        AU Card xx5369,4125.69,-0.000354169
26/12/18,25,Refund Purchase BEEM IT                  BEEM.COM.AU  AU,4141.19,0.002153467
25/12/18,-11,Harlow Richmond VI AUS Card xx5369 Value Date: 21/12/2018,4116.19,-0.007450505
25/12/18,-19.99,PRICELINE CHADSTONE CHADSTONE  AUS Card xx5369 Value Date: 19/12/2018,4127.19,-0.008390294
24/12/18,25,Refund Purchase BEEM IT                  BEEM.COM.AU  AU,4147.18,0.002153467
24/12/18,-100,COLES 4583               MIAMI        AU,4122.18,0.001615956
24/12/18,-10,WET 'N' WILD             OXENFORD     AU,4222.18,0.003519046
24/12/18,16,Refund Purchase BEEM IT                  BEEM.COM.AU  AU,4232.18,0.002153467
24/12/18,79,Refund Purchase BEEM IT                  BEEM.COM.AU  AU,4216.18,0.002153467
24/12/18,237,Transfer from REBEKAH KING NetBank Wet and wild,4137.18,0.002385506
24/12/18,79,Refund Purchase BEEM IT                  BEEM.COM.AU  AU,3900.18,0.002153467
23/12/18,31.5,Refund Purchase BEEM IT                  BEEM.COM.AU  AU,3821.18,0.002153467
23/12/18,-62.95,DAN MURPHYS LIQ 2427     BURLEIGH WATEAU Card xx5369,3789.68,-0.006910452
23/12/18,-1250,Transfer to other Bank CommBank app accomodation,3852.63,-0.007432003
22/12/18,72,Refund Purchase BEEM IT                  BEEM.COM.AU  AU,5102.63,0.002153467
22/12/18,-14,SOUL PRESS BRIGHTON PT   BRIGHTON     AU Card xx5369,5030.63,-0.001177864
22/12/18,-100,Wdl ATM CBA ATM  CHADSTONE 5    VIC 346491   AUS,5044.63,-0.005762868
22/12/18,-16.8,Rozzis Chadstone         Chadstone    AU,5144.63,0.005932872
22/12/18,-449.95,APPLE STORE R180 CHADSTONE AU AUS Card xx5369 Value Date: 19/12/2018,5161.43,-0.007092407
21/12/18,-31.51,AA CHURCH STREET 02 RICHMOND          AU,5611.38,-0.001074541
21/12/18,-20,Harlow                   Richmond     AU,5642.89,-0.00197998
21/12/18,-8.34,BASK HOTELS PTY LTD RICHMOND AU AUS Card xx5369 Value Date: 18/12/2018,5662.89,-0.004329894
20/12/18,-21.05,Direct Debit 010758 AHM 33695678,5671.23,-0.002965325
20/12/18,-9,7 GRAMS RICHMOND VI AUS Card xx5369 Value Date: 18/12/2018,5692.28,-0.008619416
20/12/18,-11.79,AMBULANCE VICTORIA MELBOURNE  AUS Card xx5369 Value Date: 14/12/2018,5701.28,-0.004609757
20/12/18,-65.34,4TH CHAPTER PTY LTD PRAHRAN VI AUS Card xx5369 Value Date: 15/12/2018,5713.07,-0.004425232
19/12/18,-19.5,BERTIES BUTCHERS RICHM   RICHMOND     AU Card xx5369,5778.41,-0.009246348
19/12/18,-0.55,International Transaction Fee Value Date: 16/12/2018,5797.91,0.006743108
19/12/18,-18.38,EIG*HOSTGATOR.COM 713-5745287 MA USA Card xx5369 USD 13.15 Value Date: 16/12/2018,5798.46,-0.004353466
19/12/18,-24.24,HELLO SAM SOUTH YARRA VI AUS Card xx5369 Value Date: 14/12/2018,5816.84,-0.004117647
18/12/18,-60,BEEM IT                  BEEM.COM.AU  AU Card xx5369,5841.08,-0.003031447
17/12/18,-17.5,BERTIES BUTCHERS RICHM   RICHMOND     AU Card xx5369,5901.08,-0.009246348
15/12/18,32,Refund Purchase BEEM IT                  BEEM.COM.AU  AU,5918.58,0.002153467
15/12/18,-9,7 GRAMS RICHMOND VI AUS Card xx5369 Value Date: 13/12/2018,5886.58,-0.008619416
15/12/18,-8.1,VINE HOTEL RICHMOND RICHMOND VI AUS Card xx5369 Value Date: 11/12/2018,5895.58,-0.006836094
13/12/18,-111.04,"Direct Debit 119218 VODAFONE T1,2C9522,16",5903.68,-0.006269228
13/12/18,-21.05,Direct Debit 010758 AHM 33695678,6014.72,-0.002965325
13/12/18,-52.2,Direct Debit 125206 FITNESS FIRST RI 015600018025010022,6035.77,-0.006010682
13/12/18,4256.45,Salary realestate.com.a 00REA Salary,6087.97,-0.004520114
13/12/18,-9,7 GRAMS RICHMOND VI AUS Card xx5369 Value Date: 11/12/2018,1831.52,-0.008619416
13/12/18,-7,SAINT THOMAS COFFE RICHMOND VI AUS Card xx5369 Value Date: 11/12/2018,1840.52,-0.004490636
12/12/18,-1008,Transfer to other Bank CommBank app pimp money,1847.52,-0.006002204
12/12/18,2000,Transfer from xx4944 CommBank app,2855.52,-0.010287876
12/12/18,-12,Transfer To T Peer PayID Email from CommBank app medium Thai,855.52,-0.009973861
12/12/18,-9,7 GRAMS RICHMOND VI AUS Card xx5369 Value Date: 10/12/2018,867.52,-0.008619416
12/12/18,-4,SQ *HERESY PTY LTD Cremorne VI AUS Card xx5369 Value Date: 10/12/2018,876.52,-0.00625867
12/12/18,-15.3,VILLAGE KNOX WANTIRNA SOUT VI AUS Card xx5369 Value Date: 08/12/2018,880.52,-0.006568689
12/12/18,-18,JMJR PTY LTD THORNBURY VI AUS Card xx5369 Value Date: 08/12/2018,895.82,-0.006921923
12/12/18,-43.3,Village Knox SOUTH YARRA VI AUS Card xx5369 Value Date: 08/12/2018,913.82,-0.006525529
11/12/18,-5.93,UBER   *TRIP PEFDC SYDNEY NS AUS Card xx5369 Value Date: 07/12/2018,957.12,-0.000655154
11/12/18,-8,Pullman & Mercure Melb Melbourne VI AUS Card xx5369 Value Date: 07/12/2018,963.05,-0.004320037
11/12/18,-94.94,DISCOVERY HOLIDAY PARK ADELAIDE  AUS Card xx5369 Value Date: 08/12/2018,971.05,-0.005564977
11/12/18,-282.65,JETSTAR MELBOURNE  AUS Card xx5369 Value Date: 08/12/2018,1065.99,-0.003787811
10/12/18,-400,Wdl ATM CBA ATM  WINDSOR        VIC 316297   AUS,1348.64,-0.006285476
10/12/18,1000,Transfer from xx4944 CommBank app,1748.64,-0.010287876
8/12/18,-13,LOVE PHO RICHMOND VI AUS Card xx5369 Value Date: 04/12/2018,748.64,-0.008008501
7/12/18,-9,7 GRAMS RICHMOND VI AUS Card xx5369 Value Date: 05/12/2018,761.64,-0.008619416
6/12/18,-21.05,Direct Debit 010758 AHM 33695678,770.64,-0.002965325
6/12/18,-5.5,7-ELEVEN 1185 RICHMOND EAST VI AUS Card xx5369 Value Date: 04/12/2018,791.69,-0.006762207
6/12/18,-10.6,MCDONALDS VERMONT STH VERMONT SOUTH  AUS Card xx5369 Value Date: 02/12/2018,797.19,-0.005623153
6/12/18,-14.2,MCDONALDS LEONGATHA LEONGATHA  AUS Card xx5369 Value Date: 02/12/2018,807.79,-0.008341283
5/12/18,-9,7 GRAMS RICHMOND VI AUS Card xx5369 Value Date: 03/12/2018,821.99,-0.008619416
5/12/18,-4.76,kikki.K Chapel Street South Yarra VI AUS Card xx5369 Value Date: 03/12/2018,830.99,-0.007434531
5/12/18,-40.08,BP BERWICK 5846 BERWICK VI AUS Card xx5369 Value Date: 02/12/2018,835.75,-0.004307996
4/12/18,-75,SOCIAL SPORT PTY LTD     RICHMOND     AU Card xx5369,875.83,-0.005229992
4/12/18,-17.5,THE BEER & BURGER CA RICHMOND VI AUS Card xx5369 Value Date: 29/11/2018,950.83,-0.007948959
4/12/18,-26.13,CASEY PHARMACY BERWICK VI AUS Card xx5369 Value Date: 29/11/2018,968.33,-0.007926202
4/12/18,-23,LIQUORLAND 3776 BERWICK AU AUS Card xx5369 Value Date: 29/11/2018,994.46,-0.00399952
4/12/18,-34.5,NOODLE & SUSHI COMBO BERWICK VI AUS Card xx5369 Value Date: 29/11/2018,1017.46,-0.00868983
3/12/18,-180,THE MEAT & WINE CO HAW   HAWTHORN EASTAU Card xx5369,1051.96,-0.00854228
30/11/18,30,Refund Purchase BEEM IT                  BEEM.COM.AU  AU,1231.96,0.002153467
30/11/18,-9,7 GRAMS RICHMOND VI AUS Card xx5369 Value Date: 28/11/2018,1201.96,-0.008619416
30/11/18,-8.5,DENIS THE MENANCE CREMORNE VI AUS Card xx5369 Value Date: 28/11/2018,1210.96,-0.005070437
30/11/18,-65,SUSAN REP PTY LTD CAMBERWELL VI AUS Card xx5369 Value Date: 26/11/2018,1219.46,-0.005967787
29/11/18,-21.05,Direct Debit 010758 AHM 33695678,1284.46,-0.002965325
29/11/18,-52.2,Direct Debit 125206 FITNESS FIRST RI 015600018025010021,1305.51,-0.006010682
29/11/18,-9.5,COLES 0573 PRAHRAN AU AUS Card xx5369 Value Date: 27/11/2018,1357.71,-0.002560467
29/11/18,-115.33,4TH CHAPTER PTY LTD PRAHRAN VI AUS Card xx5369 Value Date: 24/11/2018,1367.21,-0.004425232
28/11/18,-129.99,KATHMANDU PTY LIMITE     PRAHRAN      AU Card xx5369,1482.54,-0.001657862
28/11/18,-14.29,ADOBE  PHOTOGPHY PLAN 1800614863 IR IRL Card xx5369 AUD 14.29 Value Date: 26/11/2018,1612.53,-0.00332597
28/11/18,-74.55,Langmore Clinic Berwick VI AUS Card xx5369 Value Date: 26/11/2018,1626.82,-0.005076609
28/11/18,-15,THE VAUCLUSE HOTEL RICHMOND VI AUS Card xx5369 Value Date: 23/11/2018,1701.37,-0.005288606
28/11/18,-31.5,THE YO MY COMPANY PT GLEN WAVERLEY VI AUS Card xx5369 Value Date: 24/11/2018,1716.37,-0.008005225
28/11/18,-14.2,SAN REMO FISHERMANS CO SAN REMO VI AUS Card xx5369 Value Date: 25/11/2018,1747.87,-0.006808164
27/11/18,-100,EZI*MELBOURNE BICYCLE PRAHAN VI AUS Card xx5369 Value Date: 22/11/2018,1762.07,-0.010156878
27/11/18,-40.3,COLES EXPRESS 6976 GLEN WAVERLEY AU AUS Card xx5369 Value Date: 23/11/2018,1862.07,-0.00460864
27/11/18,-6.3,BOROONDARA CITY COUN CAMBERWELL  AUS Card xx5369 Value Date: 26/11/2018,1902.37,-0.011550276
26/11/18,37.6,Refund Purchase Medicare Benefit,1908.67,0.001554223
26/11/18,-96.98,KATHMANDU PTY LTD        CHADSTONE    AU Card xx5369,1871.07,-0.004632581
25/11/18,-30,BEEM IT                  BEEM.COM.AU  AU Card xx5369,1968.05,-0.003031447
24/11/18,-18.99,SOUL PRESS BRIGHTON PT   BRIGHTON     AU Card xx5369,1998.05,-0.001177864
24/11/18,-1102,MELB BICYCLE CNTR   www.bikes.com.au  AU,2017.04,-0.008745912
24/11/18,2000,Transfer from xx4944 CommBank app,3119.04,-0.010287876
24/11/18,25,Refund Purchase BEEM IT                  BEEM.COM.AU  AU,1119.04,0.002153467
24/11/18,-25.16,BP MALVERN 0559 MALVERN VI AUS Card xx5369 Value Date: 21/11/2018,1094.04,-0.004307996
24/11/18,-5.38,UBER   *TRIP RGHFK SYDNEY NS AUS Card xx5369 Value Date: 22/11/2018,1119.2,-0.000655154
24/11/18,-27,THAI AYOTHAYA MELB RICHMOND VI AUS Card xx5369 Value Date: 20/11/2018,1124.58,-0.009012562
23/11/18,-60.8,Eating House Rowville Rowville VI AUS Card xx5369 Value Date: 21/11/2018,1151.58,-0.007025396
23/11/18,-9,7 GRAMS RICHMOND VI AUS Card xx5369 Value Date: 21/11/2018,1212.38,-0.008619416
22/11/18,-21.05,Direct Debit 010758 AHM 33695678,1221.38,-0.002965325
22/11/18,-51.76,4TH CHAPTER PTY LTD PRAHRAN VI AUS Card xx5369 Value Date: 17/11/2018,1242.43,-0.004425232
21/11/18,-20,RAILWAY HOTEL WINDSO     WINDSOR      AU Card xx5369,1294.19,-0.003159672
21/11/18,-180,RADIO MEXICO TAQUERI ST KILDA VI AUS Card xx5369 Value Date: 16/11/2018,1314.19,-0.007710701
21/11/18,-40,GENERAL PANTS 84 CHADSTONE VI AUS Card xx5369 Value Date: 17/11/2018,1494.19,-0.003686502
21/11/18,-5.5,COLES 0573 PRAHRAN AU AUS Card xx5369 Value Date: 19/11/2018,1534.19,-0.002560467
20/11/18,30,Refund Purchase BEEM IT                  BEEM.COM.AU  AU,1539.69,0.002153467
20/11/18,-0.54,International Transaction Fee Value Date: 16/11/2018,1509.69,0.006743108
20/11/18,-18.13,EIG*HOSTGATOR.COM 713-5745287 MA USA Card xx5369 USD 13.15 Value Date: 16/11/2018,1510.23,-0.004353466
18/11/18,-60,BEEM IT                  BEEM.COM.AU  AU Card xx5369,1528.36,-0.003031447
17/11/18,-1,BEEM IT                  BEEM.COM.AU  AU Card xx5369,1588.36,-0.003031447
17/11/18,1,Refund Purchase BEEM IT                  BEEM.COM.AU  AU,1589.36,0.002153467
17/11/18,-269.99,KATHMANDU PTY LIMITE     CHADSTONE    AU,1588.36,0.000966314
17/11/18,-80,BEEM IT                  BEEM.COM.AU  AU Card xx5369,1858.35,-0.003031447
17/11/18,-58,DE BARGE HAIR            MOUNT WAVERLEAU Card xx5369,1938.35,-0.002914702
17/11/18,26,Refund Purchase BEEM IT                  BEEM.COM.AU  AU,1996.35,0.002153467
17/11/18,5,Refund Purchase BEEM IT                  BEEM.COM.AU  AU,1970.35,0.002153467
17/11/18,-12,COLES 0573 PRAHRAN AU AUS Card xx5369 Value Date: 15/11/2018,1965.35,-0.002560467
16/11/18,90,Refund Purchase BEEM IT                  BEEM.COM.AU  AU,1977.35,0.002153467
16/11/18,45,Refund Purchase BEEM IT                  BEEM.COM.AU  AU,1887.35,0.002153467
16/11/18,13.75,Direct Credit 158824 WANG YANXIANG Lunch payment for,1842.35,-0.004108336
16/11/18,13.75,Transfer from JONATHAN SCHOELL CommBank app spicy,1828.6,-0.007368236
16/11/18,13.75,Direct Credit 421520 ARATHY JANARDHAN,1814.85,-0.005493333
16/11/18,-55.2,TIAN FU HOT POT PL    SOUTH YARRA  VICAU,1801.1,-0.008699521
15/11/18,-21.05,Direct Debit 010758 AHM 33695678,1856.3,-0.002965325
15/11/18,-52.2,Direct Debit 125206 FITNESS FIRST RI 015600018025010020,1877.35,-0.006010682
15/11/18,75,Transfer From Miss Darci May Campbell netty spaghetti,1929.55,0.001525621
15/11/18,-30.25,7-ELEVEN 1286 GLEN WAVERLEY VI AUS Card xx5369 Value Date: 12/11/2018,1854.55,-0.006632262
15/11/18,-12.18,THE YO MY COMPANY PT GLEN WAVERLEY VI AUS Card xx5369 Value Date: 12/11/2018,1884.8,-0.008005225
15/11/18,-14.5,HUNKY DORY FISH RICHMOND VI AUS Card xx5369 Value Date: 13/11/2018,1896.98,-0.004072054
15/11/18,-6.8,Gelato Messina Richmond VI AUS Card xx5369 Value Date: 13/11/2018,1911.48,-0.006191732
15/11/18,-60,RETAIL PRODIGY OPS PL FOUNTAIN GATE  AUS Card xx5369 Value Date: 11/11/2018,1918.28,-0.006604131
14/11/18,-4000,Transfer to xx4944 CommBank app,1978.28,-0.012711523
14/11/18,400,Direct Credit 421520 ABAS PROPERTY SO 0139,5978.28,-0.008986221
14/11/18,-15,BERTIES BUTCHERS RICHM   RICHMOND     AU Card xx5369,5578.28,-0.009246348
14/11/18,4230.33,Salary realestate.com.a 00REA Salary,5593.28,-0.004520114
14/11/18,-34.99,REBEL FOUNTAIN GATE FOUNTAIN GATE VI AUS Card xx5369 Value Date: 11/11/2018,1362.95,-0.010991866
14/11/18,-8,THE SWAN RICHMOND VI AUS Card xx5369 Value Date: 09/11/2018,1397.94,-0.005441819
14/11/18,-18.5,THE SWAN RICHMOND VI AUS Card xx5369 Value Date: 09/11/2018,1405.94,-0.005441819
14/11/18,-12.5,THE SWAN RICHMOND VI AUS Card xx5369 Value Date: 09/11/2018,1424.44,-0.005441819
13/11/18,-111.04,"Direct Debit 119218 VODAFONE T1,2C4741,C",1436.94,-0.006269228
13/11/18,-150,SOCIAL SPORT PTY LTD     RICHMOND     AU Card xx5369,1547.98,-0.005229992
13/11/18,-23.1,GOOGLE*DOMAINS G.CO HELPPAY# AU AUS Card xx5369 Value Date: 09/11/2018,1697.98,-0.00399952
13/11/18,-4,K Z ENTERPRSS AUST P RICHMOND VI AUS Card xx5369 Value Date: 08/11/2018,1721.08,-0.007899727
12/11/18,-17,BERTIES BUTCHERS RICHM   RICHMOND     AU Card xx5369,1725.08,-0.009246348
10/11/18,-300,Wdl ATM CBA ATM  WINDSOR        VIC 316297   AUS,1742.08,-0.006285476
10/11/18,-0.5,International Transaction Fee Value Date: 07/11/2018,2042.08,0.006743108
10/11/18,-16.77,ENVATOMARKET44285596 61383766284 UT USA Card xx5369 USD 12.10 Value Date: 07/11/2018,2042.58,-0.003263367
9/11/18,-20,Wdl ATM CBA ATM  ABBOTSFORD A   VIC 321701   AUS,2059.35,-0.007115296
9/11/18,-9,7 GRAMS RICHMOND VI AUS Card xx5369 Value Date: 07/11/2018,2079.35,-0.008619416
8/11/18,300,Direct Credit 421520 PLATINUM PHYSIO 138,2088.35,-0.006056038
8/11/18,-21.05,Direct Debit 010758 AHM 33695678,1788.35,-0.002965325
8/11/18,-9.8,WEI TONG PTY. LTD.       RICHMOND     AU Card xx5369,1809.4,-0.00509521
7/11/18,-9,7 GRAMS RICHMOND VI AUS Card xx5369 Value Date: 05/11/2018,1819.2,-0.008619416
7/11/18,-3.7,7 GRAMS RICHMOND VI AUS Card xx5369 Value Date: 05/11/2018,1828.2,-0.008619416
7/11/18,-31.88,COLES EXPRESS 6976 GLEN WAVERLEY AU AUS Card xx5369 Value Date: 04/11/2018,1831.9,-0.00460864
6/11/18,74,Refund Purchase BEEM IT                  BEEM.COM.AU  AU,1863.78,0.002153467
6/11/18,5,Refund Purchase BEEM IT                  BEEM.COM.AU  AU,1789.78,0.002153467
6/11/18,-20.89,SOUL PRESS BRIGHTON PT   BRIGHTON     AU Card xx5369,1784.78,-0.001177864
6/11/18,-14.6,COLES 0677 VERMONT SOUTH AU AUS Card xx5369 Value Date: 02/11/2018,1805.67,-0.002203631
6/11/18,-14.04,UBER   *TRIP VQQ3D SYDNEY NS AUS Card xx5369 Value Date: 02/11/2018,1820.27,-0.000655154
6/11/18,-1,COLES 7998 RICHMOND AU AUS Card xx5369 Value Date: 02/11/2018,1834.31,-0.003782528
6/11/18,-10.1,MCDONALDS CROWN SOUTHBANK  AUS Card xx5369 Value Date: 02/11/2018,1835.31,-0.00940786
5/11/18,-11000,Transfer to xx4944 CommBank app,1845.41,-0.012711523
5/11/18,6028.98,Direct Credit 002962 CITIGROUP PTYLTD WEBSITE,12845.41,-0.001114577
3/11/18,-4.69,UBER TRIP SYMY5 HELP.U 14518236738 AU AUS Card xx5369 Value Date: 01/11/2018,6816.43,-0.000777846
3/11/18,-33,THAI AYOTHAYA MELB RICHMOND VI AUS Card xx5369 Value Date: 30/10/2018,6821.12,-0.009012562
2/11/18,-12.4,WEI TONG PTY. LTD.       RICHMOND     AU Card xx5369,6854.12,-0.00509521
2/11/18,-9,7 GRAMS RICHMOND VI AUS Card xx5369 Value Date: 31/10/2018,6866.52,-0.008619416
2/11/18,-39,CROWN MEL FUSION BAR     SOUTHBANK    AU Card xx5369,6875.52,-0.0088654
1/11/18,-21.05,Direct Debit 010758 AHM 33695678,6914.52,-0.002965325